Wog, Wog, Wog, Wog, Wog, Wog, Wog, Wwrg, Mm, Mm, Mm, Mm, Md, Mm, Mm^Xm, Xu, UzwY, Xu, Xu, Mm^Xm, Mm^Xm, Mm^Xm, Mm^Xm, Mm^Xm, Mm^Xm, Mm^Xm, Mm^Xm
Wog, Wog, Wog, Wog, Wog, Wog, Wog, Wwrg, Wwrg, Mm, Md, Md, Md, Md, Md, Xu, UzwY^Ii, UzwY, Xu, Mm^Xm, Mm, Mm^Xm, Ch, Mm^Xm, 1 Kh, Mm^Xm, Mm^Xm
Wwrg, Wog, Wog, Wog, Wog, Wog, Wwg, Wwg, Wwg, Ss, Mm, Md, Md, Md, Gll, UzwY^Ii, Xu, Xu, Hh, Mm, Mm, Rr, Ch, Ch, Ch, Mm^Xm, Mm^Xm
Md, Wwrg, Wwrg, Wwrg^Bw\r, Wwrg^Bw\r, Wwg, Wwg^Bw/r, Wwg, Wwg, Ss, Ss, Wwrg, Hhd, Gd^Emf, Gll, Gll^Fdw, Gll, Hhd, Hh, Hh, Rr, Rr, Rr, Ch, Rr, Mm^Xm, Mm^Xm
Md, Md, Md, Wwrg, Wwrg, Wwg^Bw\, Wwg, Wwg, Wwg, Wwg, Ss, Hhd, Gll, Gll^Fdw, Gll, Gll, Gd, Gg, Gg, Hh, Wwf^Bsb|, Wwrg, Wwf, Rr, Wwrg, Mm^Xm, Mm^Xm
Md, Md, Md, Wwrg, Ss, Wwrg^Bw|, Ss, Ss, Ss, Wwg, Wwrg, Gd, Gd^Esd, Gll, Gd, Gd, Gs^Fms, Gg, Wwrg, Wwrg, Rp, Hh, Hh, Wwf, Mm^Xm, Mm^Xm, Mm^Xm
Md, Md, Hhd, Hhd, Gd, Gd, Hhd, Ss, Hhd, Gd^Dr, Wwrg, Gd, Gd, Gd, Gd^Emf, Hhd, Gs^Fms, Gs^Fms, Wwf, Gg, Rp, Hh, Hh, Mm, Mm, Mm^Xm, Mm
Hhd, Hhd, Hhd, Hhd, Gd, Gs, Gs, Hhd, Gs, Gd, Gs, Wwf, Wwf, Gd, Gd, Gd, Gll^Fdw, Gg^Efm, Wwf, Gg, Rp, Hh, Hh, Mm, Mm, Mm, Mm
Rb, Hhd, Rd, Gd, Re, Gd, Gg, Gd, Gg, Gd, Gg, Gd, Gg, Wwrg, Hh, Hh, Gs^Fms, Gg^Efm, Wwrg, Gg, Rr, Gg^Gvs, Hh, Hh, Mm, Mm, Mm
Rb, Rb, Rb, Rd, Re, Re, Gg, Gg, Gg^Efm, Gg, Gg^Efm, Gg, Gg, Wwf, Wwf, Hh, Wwf, Wwf, Gg^Gvs, Gg^Gvs, Rp, Gg^Gvs, Hh, Hh, Mm, Mm, Mm
Rb, Uu^Vud, Rb, Rd, Re, Re, Gg, Gg, Gg, Gs^Fms, Gg, Gg^Efm, Gg^Eff, Gg^Eff, Gg^Eff, Wwrg, Gg^Gvs, Gg^Gvs, Gg^Gvs, Gg^Gvs, Rp, Gg^Efs, Gg^Eff, Gg^Eff, Hh, Mm, Mm
Rd, Rb, Rd, Rd, Re, Re, Gg, Gg, Gg^Vwm, Gg, Gg^Eff, Gg, Gg^Efm, Gg^Efm, Gg^Efm, Wwf, Gg^Eff, Gg^Gvs, Gg, Gg^Efs, 2 Rr, Gg^Eff, Gd, Gs^Vh, Hh, Hh, Hh
Gll^Fdw, Gll^Fdw, Gll^Fdw, Re, Gll, Gg, Gg, Gg, Gg^Gvs, Gg^Eff, Gg^Eff, Gg^Efm, Gg^Efm, Gg^Ve, Re, Wwf, Gd^Eff, Gg^Eff, Re^Eff, Gg^Eff, Rr, Gg, Gg, Gg, Gd, Hh^Vhh, Gd
Gll^Fdf, Gll^Fdw, Gll^Fdf, Gll^Fdf, Gs^Fms, Gg, Gg^Gvs, Gg^Gvs, Gg^Gvs, Gg^Gvs, Gg^Eff, Gg^Eff, Gd^Eff, Gg^Efm, Gg^Eff, Wwrg^Bw\, Wwrg^Bw\, Re, Gd, Gs^Vh, Rr^Esd, Re, Gs^Vh, Gs, Gs, Gg^Efm, Gd
Gll, Gll, Gs^Fms, Gll^Fdf, Gs^Fms, Gg, Gg, Gg^Gvs, Gg^Eff, Gg^Eff, Gs, Gd, Re, Gs^Eff, Gs^Vh, Re, Wwf, Gd^Efs, Gg^Efm, Gd, Rr^Esd, Gg^Efm, Gd^Efs, Re, Gs^Vh, Gd, Gd
Gg, Gll, Gs^Fms, Gs^Fms, Gs^Fms, Gs^Fms, Gs^Fms, Gg, Gs^Fms, Gg^Eff, Gg^Eff, Gs^Vh, Gd^Efs, Re^Esd, Re, Gd, Rp, Wwf, Wwf^Bw/, Rp, Wwf^Bw|, Wwf, Wwf, Wwf, Wwrg, Wwf, Wwf
Gs^Fms, Gs^Fms, Gs, Gs^Fms, Gs, Gs^Fms, Re, Re, Re, Gs^Fms, Gg^Eff, Gg^Eff, Gs, Gd^Esd, Gg^Efm, Rp, Rr, Rr^Vhc, Rr^Esd, Wwf, Gg, Re, Gg^Efm, Gs^Vh, Re, Gd, Gd
Gs^Fms, Gs^Fms, Gs, Gs, Re, Re, Gs^Fms, Gs^Fms, Gg^Eff, Re, Re, Gs^Vh, Gs^Efs, Gg^Edb, Re, Rp, Rp^Esd, Rr^Ebn, Rp, Wwf^Bw\, Re, Re, Re, Re, Gs^Vh, Re^Esd, Gs
Gs^Fms, Gs^Vl, Re, Re, Gs^Vl, Gs, Gs^Fms, Gg^Eff, Gg^Eff, Gs^Vl, Gd^Esd, Re, Re, Re, Re^Esd, Gs^Vh, Gd, Rp, Wwrg, Wwf, Re^Esd, Gs^Efs, Gg^Wm, Gg^Efm, Re, Re, Gd
Re, Re, Gs^Fms, Gs, Gs^Fms, Gs^Fms, Gg^Eff, Gg^Eff, Gg^Gvs, Gg^Eff, Gg^Eff, Gd, Re, Gs, Gg^Esd, Gg^Wm, Gs^Efs, Wwf, Gg^Efm, Gs^Vh, Re, Re, Gs^Vh, Re, Gs^Vh, Gg, Gs
Gg, Gs^Fms, Gs^Fms, Gs^Fms, Gg^Eff, Gg^Eff, Gg^Gvs, Gg^Gvs, Gg^Gvs, Gg^Gvs, Gg^Gvs, Re, Gg^Eff, Re, Gs^Vh, Gd, Wwf^Bw\r, Wwf, Gs^Vh, Re, Gs, Gs^Esd, Gg^Efm, Gg^Efm, Gg^Efm, Gs, Gd
Gg^Gvs, Gs^Fms, Gg^Gvs, Gg^Eff, Gg^Gvs, Gg^Gvs, Gg^Gvs, Gg^Gvs, Gg^Gvs, Gg^Gvs, Gg^Gvs, Gg^Gvs, Gg^Gvs, Gg^Eff, Gg^Eff, Gd, Wwf, Gd, Gd, Gg^Efs, Gd, Gd, Gd, Gd, Gd, Gd, Gd
