Qlf, Qlf, Qlf, Uu, Uu, Uu, ZvW, Uu^Em, Uu, Uu, Xos, Xos, Urb, Urb, Urb, Xos, Xos, Uu, Uu^Vu, Uu, Uu^Vud, Uu, Uu
Qlf, Qlf, Qlf, Qlf, Qlf, Uu^Uf, Uu^Uf, ZvW, Uu, Uu, Ql, Urb, Urb, 2 KdwY, Urb, Urb, Ql, Uu, Uu^Em, Uu^Dr, Uu, Uu, Uu
Uu, Qlf, Qlf, Ql, QxvY, Qlf, Qlf, ZvW, Ql, Ql, Urb, CdwY, Urb, CdwY, Urb, CdwY, Urb, Ql^Bs/, Ql, Uu^Em, Uu^Em, Uu^Vud, Uu
Uu, Qlf, Qlf, Ql, QxvY, Ql, Ql, Ql^Bs|, Ql, Urb, Urb^QcnZ, Urb, Urb, Urb, Urb, Urb, Urb^QcsZ, Urb, Ql, Ql^Bs|, Qlf, Uu, Qlf
Uu^Esd, Uu, Uu, Qlf, Ql, QxvY, Qlf, ZvW, ZvW, Ql, Ql, Urb^QcnZ, Urb^QcnZ, Urb, Urb^QcsZ, Urb^QcsZ, Ql, Ql, ZvW, ZvW, Qlf, Qlf, Qlf
Uu, ZvW, Mv, Qlf, Qlf, Qlf, Urb, Urb, Urb, ZvW, Ur, Ql, Ql, Urb^QcsZ, Ql, Ql, Ur, ZvW, Urb, Urb, Urb, Qlf, Qlf
Uu, Md^Es, Md, Md^Es, Qlf, Qlf, QxvY, Urb, Urb, Urb, Urb^Es, ZvW, Ur, Ql, Ur, Ur, Urb^Edt, Urb, Urb, Urb, Uu^Vud, Uu^Vu, Uh
Uu, Uu, ZvW, Qlf, QxvY, Ql, Qlf, Uu^Uf, ZvW, Urb, Urb, Urb^Edt, Urb, Ur, Urb, Urb^Edt, Urb, Urb, Uu^Vu, Re^Vpr, Mv, Uh, Uh
Uu, ZvW, ZvW, Qlf, Ql, Ql, Ql^Bs/, Qlf^Bs/, Uu, Uu^Vu, ZvW, Urb, Urb, Ur, Urb^Em, Urb, ZvW^Em, Uu^Vu, Uu, Md, Md, Md, Qlf
Uu^Uf, Uu^Dr, Uu, ZvW, Ql^Bs/, QxvY^Bs/, Ql, Qlf, Qlf, Uu^Vud, Uu^Dr, Uu^Vu, Urb^Es, ZvW, Urb^Esd, Uu^Vu, Uu, Uu^Vud, Qlf, Uu^Vud, Qlf, Qlf, Uu
Uu, Uu^Uf, Uu, ZvW, Ql, QxvY, QxvY, Ql, QxvY, Uu^Vu, Uu, Uu^Vud, Urb, 1 ZvW, Urb, Uu^Em, Uu, Qlf, Uu^Vud, Qlf, Uu^Vud, Uu^Vud, Uu
Uu, Uu^Uf, Uu, Uu, Uu, Ql, Ql, Ql, Uu, Uu^Vu, Uu, Xos, Urb, ZvW, Urb, Xos, Qlf, Qlf, Uu, Uu, Uu, Uu, Uu
