Ql, Ql, Ql, Ql, Uu, Uu, Uu, Uu, Uu, Uu, Uu, Uu, Uu, Uu, Ql, Uu, Uu, Uu, Uu, Uu, Uu, Uu, Uu, Uu, Uu, UzwY, Uu, Uu, Uu, Uu, Uu, Uu, Uu, Uu, Xu, Xu, Xu, Xu, Xu, Xu, Xu, Xu, Xu, Xu, Xu, Xu, Qlf, Xu, Xu, Xu, Xu, Xu, Xu, Xu, Xu, Xu, Xu, Xu
Ql, Ql, Ql, Ql, Ql, Uu, Uu, Uu, Ql, Uu, Ql, Uu, Ql, Ql, Uu, Uu, Uu, Uu, Uu, Uu, Uh, Uu, Uu, Uu, Uu, UzwY, UzwY, Uu, Uu, Uh, Uh, Uu, Uu, Xu, Uu, Xu, Xu, Xu, Xu, Xu, Xu, Xu, Xu, Xu, Xu, Xu, Qlf, Xu, Xu, Xu, Xu, Xu, Xu, Xu, Xu, Xu, Xu, Xu
Ql, Ql, Ql, Ql, Ql, Uu, Ql, Uu, Uu, Ql, Uu, Ql, Uu, Ql, Ql, Uu, Ql, Uu, Uu, Uh, Uu, Uu, Uh, Uu, Uh, Uu^Viyv, UzwY, Uu, CtY, CtY, CtY, Uh, Uu^Viyv, Uu, Xu, Uu, Xu, Xu, Xu, Xu, Xu, Xu, Xu, Xu, Xu, Qlf, Xu, Xu, Xu, Xu, Xu, Xu, Xu, Xu, Xu, Xu, Xu, Xu
Uu, Ql, Ql, Xu, Ql, Ql, Ql, Uu, Ql, Uu, Ql, Ql, Ql, Uh, Ql, Uu, Ql, Ql, Uu, Xu, Xu, Uu, Uh, Uh, Uu, Uu, Uu, UzwY, CtY, Ker, CtY, Uu, Uu, Uu, Xu, Xu, Xu, Uu, Xu, Xu, Xu, Uu, Uu, Xu, Xu, Qlf, Qlf, Xu, Xu, Xu, Xu, Xu, Xu, Xu, Xu, Xu, Xu, Xu
Uu, Ql, Ql, Xu, Xu, Ql, Ql, Ql, Ql, Ql, Ql, Ql, Ql, Uh, Uu, Uh, Ql, Uh, Ql, Xu, Ql, Uu, Uu, Uu, Uh, Uu, Uh, UzwY, UzwY, CtY, Uu, Uu, Uu, Uu, Uu, Uu, Uu, Uu, Xu, Xu, Uu, Uu, Xu, Xu, Xu, Qlf, Qlf, Xu, Xu, Xu, Xu, Xu, Xu, Xu, Xu, Xu, Xu, Xu
Uu, Ql, Ql, Ql, Ql, Ql, Ql, Ql, Ql, Ql, Ql, Ql, Ql, Uu, Ql, Uu, Ql, Uu, Ql, Ql, Ql, Uu, Uu, Uu, Uu, Uh, Uu, Uu, Uu, UzwY, 1 UzwY, UzwY, UzwY, Uu, Uu, Uh, Uh, Uu, Uu, Xu, Uu, Uu, Xu, Xu, Uh, Qlf, Xu, Xu, Xu, Xu, Xu, Xu, Xu, Xu, Xu, Xu, Xu, Xu
Uu, Uu, Ql, Ql, Ql, Ql, Uu, Ql, Ql, Ql, Ql, Ql, Ql, Ql, Ql, Ql, Ql, Ql, Uu, Ql, Uh, Uu, Uu, Uu, Uu, Uu, Uu, Uu, Qlf, Qlf, Qlf, Qlf, UzwY, Uu, Uu, Uu, Uh, Uh, Qlf, Qlf, Qlf, Xu, Uh, Uh, Qlf, Qlf, Uh, Xu, Xu, Xu, Xu, Xu, Xu, Xu, Xu, Xu, Xu, Xu
Uu, Ql, Uu, Uu, Uu, Uu, Uu, Ql, Uu, Ql, Ql, Ql, Ql, Ql, Ql, Ql, Ql, Uh, Uh, Uu, Ql, Uh, Ql, Uu, Xu, Uu, Uu^Viyv, Uu, Uu, Qlf, Qlf, Qlf, Uu, UzwY, UzwY, Uu, Uu, Uu, Qlf, Qlf, Uu, Uu, Uu, Uh, Qlf, Uh, Xu, Xu, Xu, Xu, Xu, Xu, Xu, Xu, Xu, Xu, Xu, Xu
Uu, Ql, Uu, Uu, Ql, Ql, Ql, Ql, Uu, Uu, Ql, Uu, Ql, Ql, Ql, Ql, Ql, Uu, Ql, Uu, Ql, Ql, Ql, Xu, Xu, Xu, Uu, Uu, Uu, Qlf, Qlf, Qlf, Uu, Uu, Uu, UzwY, UzwY, UzwY, UzwY, Qlf, UzwY, Uu^Viyv, Uu, Qlf, Uh, Uh, Xu, Xu, Xu, Xu, Xu, Xu, Xu, Xu, Xu, Xu, Xu, Xu
Uu, Uu, Uu, Ql, Ql, Uu, Ql, Ql, Uu, Uu, Uu, Uu, Ql, Ql, Ql, Ql, Ql, Ql, Ql, Ql, Ql, Uu, Uu, Xu, Ql, Ql, Uu, Uu, Uu, Uu, Uu, Uh, Uu, Uu, Uu, Uu, Uu, Uu, Uu, UzwY, Uu, UzwY, UzwY, Qlf, Uh, Uh, Uh, Uh, Xu, Xu, Xu, Xu, Xu, Xu, Xu, Xu, Xu, Xu
Uu, Uu, Uu, Uu, Uu, Uu, Uu, Uu, Qlf, Uu, Ql, Ql, Xu, Xu, Ql, Ql, Ql, Ql, Ql, Ql, Ql, Ql, Ql, Ql, Ql, Uh, Uu, Uh, Uu, Uu, Uu, Uh, Uu, Uu^Viyv, Uh, Uh, Uh, Uu, Uu, Uu, Uu, Uu, Qlf, Qlf^Bs\, UzwY, Uu, Uh, Uh, Xu, Xu, Uh, Uh, Xu, Uh, Xu, Xu, Xu, Xu
Uu, Uu, Qlf, Uu, Uu, Uu, Uu, Qlf, Ql, Uu, Ql, Uu, Xu, Xu, Ql, Ql, Uu, Ql, Ql, Ql, Ql, Ql, Ql, Ql, Uu, Uu, Ql, Ql, Ql, Uh, Uu, Uu, Ql, Uu, Ql, Uu, Uu, Uu, Uu, Uu^Viyv, Uu, Qlf, Qlf, Uh, UzwY, Uu, Uu, Xu, Xu, Uh, Uh, Xu, Xu, Uh, Uh, Xu, Uh, Xu
Uu, Qlf, Qlf, Uh, Uh, Uu, Uu, Qlf, Qlf, Ql, Qlf, Uu, Qlf, Ql, Qlf, Uu, Uu, Uu, Ql, Ql, Ql, Ql, Ql, Ql, Ql, Ql, Uu, Ql, Uh, Uh, Ql, Uu, Ql, Ql, Ql, Uu, Uu, Uu, Uh, Uh, Uu, Qlf, Qlf, Uh, Uu, UzwY, UzwY, Uu, Uh, Uh, Uu^Viyv, Uh, Uh, Uh, Xu, Xu, Uh, Uh
Xu, Uu, Uu, Uh, Uu, Uu, Uu, Uu, Qlf, Qlf, Uu, Uu, Qlf, Ql, Qlf, Qlf, Uu, Uu, Ql, Ql, Ql, Ql, Ql, Ql, Ql, Uu, Ql, Uu, Uu, Uh, Uu, Ql, Ql, Ql, Uu, Ql, Uu, Uh, Uu, Uu, Qlf, Qlf, Qlf, Uu, Uu, Uu, UzwY, Uu, UzwY, Uu, UzwY, Uu, Uh, Uh, Uh, Uh, Uh, Uh
Xu, Uu, Xu, Uu, Uu, Uu, Qlf, Qlf, Qlf, Uu, Qlf, Uu, Qlf, Qlf, Uu, Uu, Uu, Ql, Xu, Xu, Uu, Uu, Uu, Ql, Ql, Ql, Ql, Ql, Uu, Uu, Ql, Uu, Ql, Ql, Ql, Uu, Uu, Uu, Xu, Uu, Qlf, Qlf, Qlf, Uh, Uh, Uh, UzwY, UzwY, Uh, UzwY, Uu, UzwY, UzwY, Uh, Uh, Uh, Qlf, Uh
Xu, Xu, Xu, Uu, Uu, Uu, Qlf, Qlf, Uu, Qlf, Uu, Qlf, Uu, Uu, Uu, Uu, Uu, Ql, Xu, Xu, Xu, Ql, Ql, Uu, Ql, Ql, Ql, Ql, Ql, Ql, Ql, Ql, Ql, Uu, Ql, Uu, Uu, Xu, Xu, Qlf, Ql, Ql, Ql, Uh, Uu, Uu^Viyv, UzwY, Uh, Uh, UzwY, Uh, Uh, Uh, UzwY, Qlf, Uh, Qlf, Qlf
Xu, Uu, Uu, Uu, Qlf, Qlf, Qlf, Uu, Uu, Uu, Uu, Uu, Uu, Uu, Uu, Uu, Uu, Uu, Uu, Uu, Ql, Ql, Uu, Ql, Ql, Ql, Ql, Ql, Ql, Ql, Ql, Ql, Ql, Ql, Ql, Ql, Ql, Ql, Xu, Xu, Xu, Xu, Ql, Uu, Qlf, Uu, UzwY, Uu, Uu, UzwY, Uu, Uh, Qlf, Qlf^Bs|, Qlf, Qlf, Uu, Uu
Xu, Xu, Xu, Qlf, Qlf, Qlf, Qlf, Qlf, Qlf, Qlf, Qlf, Qlf, Qlf, Qlf, Qlf, Qlf, Qlf, Uu, Uu, Ql, Uu, Ql, Xu, Xu, Uu, Ql, Uh, Uh, Ql, Ql, Ql, Xu, Xu, Ql, Ql, Ql, Ql, Ql, Xu, Xu, Xu, Ql, Ql, Uu, Ql, Qlf, Qlf^Bcx|, Uu, Qlf, Qlf^Bcx|, Qlf, Qlf, Qlf, UzwY, Uu, Uh, Uh, Uu
Qlf, Xu, Qlf, Qlf, Qlf, Xu, Uu, Qlf, Qlf, Qlf, Uu, Qlf, Qlf, Uu, Xu, Qlf, Qlf, Qlf, Uu, Uu, Uu, Uu, Xu, Xu, Ql, Ql, Uh, Uh, Uh, Ql, Uh, Ql, Ql, Ql, Ql, Ql, Xu, Xu, Xu, Xu, Ql, Ql, UzwY^Viyv, Ql, UzwY^Viyv, Ql, Cud, Qlf, Cud, Cud, Qlf, Qlf, UzwY, UzwY, UzwY, Uu, Uh, Uh
Qlf, Qlf, Qlf, Qlf, Xu, Xu, Uu, Qlf, Qlf, Qlf, Xu, Qlf, Qlf, Qlf, Qlf, Qlf, Xu, Qlf, Qlf, Uu, Uu, Uu, Ql, Ql, Ql, Uh, Ql, Uh, Uh, Ql, Ql, Uh, Ql, Ql, Ql, Ql, Ql, Ql, Xu, Xu, Ql, Cud, UzwY, UzwY, UzwY, Cud, Cud, Cud, Ur, Cud, Cud, Qlf^Bcx/, Uu, Uu, Uu, UzwY, UzwY, Uu
Qlf, Qlf, Xu, Xu, Xu, Xu, Xu, Qlf, Qlf, Qlf, Qlf, Uu, Qlf, Qlf, Xu, Xu, Xu, Uu, Qlf, Uu, Uu, Uu, Uu, Uu, Uu, Uh, Uh, Ql, Ql, Ql, Uh, Uh, Ql, Ql, Ql, Ql, Ql, Ql, Ql, Ql, Ql^Bcx/, UzwY, Ql^Bcx\, Ql, Ql, Ql, Ur, 5 Kud, Cud, Cud, Qlf, Qlf, Uh, Uu^Viyv, Uu, Uh, Uh, UzwY
Xu, Xu, Xu, Xu, Uu, Xu, Uu, Uu, Uu, Qlf, Qlf, Qlf, Qlf, Qlf, Qlf, Uu, Qlf, Qlf, Qlf, Qlf, Uu, Uu, Uu, Uu, Uu, Uh, Uu, Uh, Uh, Uh, Uh, Uh, Uh, Ql, Uu, Ql, Ql, Ql, Ql^Bcx/, Ql^Bcx/, Ql, UzwY, Ql, UzwY, Ql^Bcx\, Ql, Cud, Cud, Qlf, Qlf, Xu, Xu, Xu, Uu, Uu, Uh, Uh, Uu
Xu, Xu, Xu, Xu, Uu, Uu, Uu, Uu, Uu, Qlf, Qlf, Xu, Uu, Qlf, Qlf, Qlf, Qlf, Qlf, Qlf, Qlf, Uu, Uu, Uu, Uu, Uh, Uu, Uh, Uu, Uu, Uu, Uu, Uh, Uu, Ql, Ql, Ql, Ql^Bcx/, Ql^Bcx/, Ql, Ql, Ql, Ql^Bcx|, Ql, Ql, UzwY^Viyv, UzwY, Ql, Ql, Ql, Qlf, Ql, Xu, Uu, Uu, Uh, Uh, Uu, Uu
Xu, Xu, Xu, Xu, Xu, Xu, Xu, Xu, Uu, Qlf, Qlf, Qlf, Qlf, Xu, Qlf, Qlf, Qlf, Qlf, Uu, Uu, Uu, Uu, Uh, Uh, Xu, Uh, Xu, Uh, Uh, Uh, Uh, Uu, Uu, Uu, UzwY, UzwY, Ql, Xu, Ql, Ql, Ql, Ql^Bcx|, Xu, Ql, Ql, UzwY, Ql^Bcx\, UzwY, UzwY, Ql, Uu^Viyv, Ql, Ql, Uh, Uh, Uh, Uu, Uu
Xu, Xu, Xu, Xu, Xu, Xu, Uu, Uu, Uu, Uu, Uu, Qlf, Qlf, Qlf, Qlf, Qlf, Uu, Qlf, Uu, Uu, Uu, Qlf, Uh, Uh, Xu, Xu, Xu, Uh, Xu, Uh, Uu, Uu^Viya, UzwY, UzwY, Qlf, Uu, Ql, Ql, Ql, Ql, Ql, Ql^Bcx|, Xu, Ql, Ql, Ql, Ql, UzwY, UzwY, UzwY, Uu, Ql, Ql, Uh, Uu, Uu, Uu, Uu
Xu, Xu, Qlf, Xu, Xu, Xu, Xu, Uu, Uu, Uu, Uu, Uu, Uu, Uu, Uu, Uu, Uu, Uu, Uu, Qlf, Qlf, Qlf, Uu, Uh, Uh, Xu, Xu, Xu, Xu, Uh, Uu, Uu, UzwY, Qlf, Ql, Uu, Ql, Ql, Uu, Ql, Ql, Ql^Bcx|, Ql, Xu, Xu, Ql, Ql^Bcx/, Ql^Bcx/, UzwY, UzwY, Ql, Ql, Ql, Ql, Ql, Uu, Uh, Uh
Qlf, Qlf, Qlf, Qlf, Qlf, Qlf, Qlf, Qlf, Qlf, Uu, Qlf, Uu, Uu, Uu, Uu, Uu, Qlf, Qlf, Uu, Qlf, Uu, Qlf, Qlf, Uh, Xu, Xu, Xu, Xu, Uh, Uh, Uu, UzwY, Uu, Qlf, Ql, Uu, Ql, Uu^Viya, Uu, Ql, UzwY, Ql^Bcx|, Ql, Ql, Ql^Bcx/, Ql^Bcx/, Ql, Ql, Ql, UzwY, Ql^Bcx\, Ql, Uu, Uu, Ql, Ql, Uu, Uu
Xu, Xu, Xu, Xu, Xu, Xu, Xu, Xu, Xu, Qlf, Uu, Qlf, Qlf, Uu, Qlf, Uu, Qlf, Qlf, Qlf^Bs|, Qlf, Uu, Uu, Uu, Qlf, Qlf, Uh, Uh, Xu, Uh, Uu, Uu, UzwY, Uu, Qlf, Qlf, Ql, Ql, Uu, UzwY, Ql, UzwY, UzwY, UzwY, Ql^Bcx/, Ql, Ql, Xu, Ql, Ql, Ql, UzwY, UzwY, Ql, Uu, Xu, Xu, Uu, Uu
Xu, Xu, Xu, Xu, Xu, Xu, Uu, Xu, Uu, Uu, Uu, Uu, Uu, Qlf, Uu, Qlf, Uu, Uu, Uu, Uu, Uu, Uu, Uu, Uu, Uu, Qlf, Uh, Uh, Uh, Qlf, Qlf, Qlf^Bs|, Qlf, Qlf, Uu, Qlf, Qlf, Qlf, UzwY, UzwY, Ql, UzwY, Ql, Ql, Ql, Ql, Ql, Ql, Ql, UzwY, UzwY, UzwY, Uu, Ql, Xu, Xu, Ql, Uu
Xu, Xu, Xu, Xu, Xu, Uu, Uu, Xu, Uu, Xu, Xu, Uu, Uu, Uu, Uu, Uu, Uu, Uu, Uu, Uu, Uu, Uu, Uu, Uu, Uu, Qlf, Uh, Uh, Uh, Qlf, Uu, UzwY, Uu, Uu, Uu, Uu, Uu, UzwY, UzwY, Ql, Ql, Uu^Viya, Ql, Ql, Ql, Ql, Ql, Ql, Ql^Bcx/, Ql^Bcx/, Ql, Ql^Bcx\, Ql^Bcx\, Ql, Uu, Ql, Uu, Uu
Xu, Xu, Xu, Xu, Xu, Xu, Xu, Uu, Xu, Xu, Xu, Uu, Xos, Uu, Uu, Uu, Uu, Uu, Uu, Uu, Uu, Uu, Xos, Uu, Xos, Qlf, Qlf, Qlf, Qlf, Qlf, Uu, UzwY, Uu, Uu, Uu, Uu, Uu, UzwY, UzwY, Uu, Uu, Ql, Ql, Ql, Ql, Ql, Ql^Bcx/, Ql^Bcx/, Ql, Ql, Ql, Ql, Ql, UzwY, Uu, Ql, Ql, Uu
Xu, Xu, Xu, Xu, Xos, Xos, Xos, Xos, Xos, Xos, Xos, Xos, Xos, Uu, Xos, Xos, Xos, Uu, Uu, Uu, Uu, Uu, Xos, Xos, Xos, Xos, Xos, Uu, UzwY, UzwY, UzwY, UzwY, UzwY, Uu, Uu, Uu, Uu, UzwY, UzwY, Uu, Ql, Ql, Uu^Viya, Ql, UzwY, Ql^Bcx/, Ql, Xu, Xu, Ql, Ql, Ql, UzwY, UzwY, Uu, Ql, Uu, Uu
Xu, Xos, Xos, Xos, Xos, Uu, Xos, Xos, Uu, Xos, Uu, Xos, Xos, Xos, Xos, Xos, Uu, Uu, Xos, Xos, Xos, Xos, Xos, Uu, Uu, Xos, UzwY, UzwY, Xos, Uu, Uu, Uu, Uu, UzwY, UzwY, Uu, UzwY, UzwY, UzwY, Uu, Uu, Ql, UzwY, UzwY, UzwY, Ql, Ql, Ql, Ql, Ql, Ql, Ql, Ql^Bcx|, Uu, Ql, Ql, Uu, Uh
Xu, Xos, Xos, Xos, Uu, Uu, UzwY, UzwY, UzwY, Uu, Xos, Xos, Xos, Xos, Uu, Uu, Xos, Xos, Xos, Xos, Uu^Viya, Xos, Xos, Xos, UzwY, UzwY, Xos, Xos, Xos, Xos, Xos, Xos, Xos, Xos, Uu, UzwY, Uu, UzwY, UzwY, Uu, UzwY, UzwY, UzwY, UzwY, Ql, Ql, Ql, Ql, Ql, Ql, Ql, Ql, Ql^Bcx|, Ql, Ql, Ql, Ql, Uu
Qlf, Xu, Xos, Xos, UzwY, UzwY, Qlf, Qlf, Qlf, UzwY, Xos, Xos, Xos, Xos, Uu, Xos, UzwY, Uu, Uu, Xos, UzwY, UzwY, UzwY, UzwY, Xos, Xos, Uu, Xos, Uu, Xos, Xos, Xos, Xos, Xos, Xos, Uu, Uu, UzwY, UzwY, UzwY, UzwY, UzwY, Uu, Ql, Ql, Ql, Uu, Ql, Uu, Uu, Uu, Ql, Ql^Bcx|, Ql, Ql, Ql, Ql, Uu
Xu, Qlf, Qlf, UzwY, Qlf, Qlf, Qlf, Uu^AYb, Qlf, UzwY, UzwY, Uu^Viya, UzwY, UzwY, UzwY, UzwY, Uu, UzwY, UzwY, UzwY, Xos, Xos, Xos, Xos, Xos, Uu, Uu, Cud, Cud, Uu, Cud, Cud, Cud, Xos, Xos, Xos, Uu, Uu, UzwY, UzwY, UzwY, UzwY, Ql, Ql, Ql, Ql, Uu, Ql, Xu, Uu, Uu, Ql, Ql^Bcx|, Xu, Ql, Ql, Ql, Ql
Xos, Xu, Xos, Qlf^Bcx|, Qlf, Uu^AYb, Qlf, Qlf, Qlf, UzwY, UzwY, UzwY, Xos, Xos, Uu, Uu, Xos, Uu, UzwY, UzwY, UzwY, UzwY, UzwY, Xos, Xos, Uu, Uu, Uu^Viya, UzwY, 3 Kud, Cud, Cud, Uu, Xos, Xos, Uu, UzwY, UzwY, UzwY, UzwY, UzwY, Uu, Uu, Ql, Ql, Uu, Ql, Ql, Xu, Ql, Uu, Ql, Ql^Bcx|, Ql, Ql, Ql, Ql, Ql
Xos, Xos, Xos, UzwY, Qlf, Qlf, Qlf, Uu^AYb, Qlf, UzwY, Uu, Xos, Uu, Xos, Uu, Xos, Xos, Xos, UzwY, Xos, Xos, UzwY, UzwY, UzwY, UzwY, Xos, Xos, Cud, Cud, Cud, Cud, UzwY, UzwY, Uu, UzwY, UzwY, UzwY, UzwY, Xos, Xos, Uu, UzwY, UzwY, Ql, Uu, Uu, Uu, Uu, Ql, Ql, Ql, Ql, UzwY, Ql, Ql, Ql, Ql, Ql
Xos, Xos, Xos, UzwY, Qlf, Uu^AYb, Qlf, Qlf, UzwY, UzwY, Uu, Uu, Xos, Uu, Uu^FoYg, Uu^FoYg, Xos, UzwY, Xos, Xos, Urb, Xos, Xos, UzwY, UzwY, UzwY, Xos, Uu, UzwY, UzwY, Xos, Uu, UzwY, UzwY, UzwY, UzwY, Xos, Xos, Xos, Xos, Xos, Uu, Uu, UzwY, UzwY, Uu, Ql, Ql, Ql, Ql, Ql, UzwY, Uu^Viya, Ql, Ql, Ql, Ql, Ql
Xos, Xos, Xos, UzwY, UzwY, Qlf, UzwY, Qlf^Bcx/, Qlf, Xos, Xos, Uu, Xos^FoYg, Xos^FoYg, UzwY^FoYg, UzwY^FoYg, UzwY^FoYg, UzwY, Xos, Urb, Urb, Urb, Xos, Xos, Xos, Xos, UzwY, UzwY, Uu, UzwY, Xos, Uu, UzwY, UzwY, UzwY, Uu, Xos, Xos, Xos, Xos, Uu, Uu, Uu, Uu, UzwY, Uu, Uu, Uu, UzwY, UzwY, UzwY, UzwY, Ql, Ql, Uu, Uu, Uu, Uu
Xos, Xos, Urc^Edb, Xos, Xos, UzwY, UzwY, Uu^Viya, Xos^FoYg, Qlf^FoYg, Qlf^FoYg, Xos^FoYg, UzwY^FoYg, UzwY^FoYg, Uu^FoYg, Xos^FoYg, UzwY, Xos, Xos, Urb, Urb, Urb, Xos, Xos, UzwY, UzwY, Uu, Xos, Xos, Xos, Uu, UzwY, UzwY, UzwY, Uu, Uu^Viya, Xos, Xos, Xos, Xos, Uu, Uu, Uu, Uu, Uu, UzwY, UzwY, Uu, UzwY, Qlf, Ql, Uu, Ql, Ql, Ql, Uu, Uu, Uu
Xos, Urc^Edb, Urc^Edb, Urc^Edb, Uu^Edb, Uu^Eb, UzwY, Xos^FoYg, Uu^FoYg, Uu^FoYg, Qlf^Bcx/, UzwY^FoYg, Uu^FoYg, Uu^FoYg, Uu^FoYg, Xos^FoYg, Xos, UzwY, Uu^Viya, Xos, UzwY, Xos, Xos, UzwY, Xos, Uu, Xos, Xos, Xos, Uu^Viya, UzwY, UzwY, UzwY, Uu, Uu, Uu, Xos, Xos, Xos, Uu, Uu, Uu, Uu, Uu, Uu, Uu, Uu, UzwY, Uu, Qlf, Qlf, Ql, Qlf, Uu, Ql, Qlf, Uu, Uu
Xos, Urc^Edb, Urc^Eb, Urc^Edb, Uu^Edb, Xos, UzwY, Xos^FoYg, UzwY^FoYg, UzwY^FoYg, Qlf^FoYg, Uu^FoYg, Uu^FoYg, Uu^FoYg, Uu^FoYg, Uu^FoYg, Xos, UzwY, UzwY, UzwY, UzwY, Xos, Uu, UzwY, Xos, Xos, Uu, Xos, UzwY, UzwY, UzwY, UzwY, UzwY, Xos, Xos, Xos, Xos, Xos, Uu, Uu, Uu, Uu, Uu, Uu, Uu, Uu, UzwY, UzwY, Uu, Uu, Qlf, Qlf, Qlf, Qlf, Qlf, Qlf, Uu, Uu
Xos, Urc^Edb, Urc^Edb, Urc^Edb, Uu^Edb, Xos, UzwY^FoYg, UzwY^FoYg, Uu^FoYg, Uu^FoYg, Qlf^FoYg, Uu^FoYg, Uu^FoYg, Uu^FoYg, Uu^FoYg, Uu^FoYg, Xos, Xos, UzwY, Uu, Uu, UzwY, UzwY, UzwY, Xos, Uu, Uu, Uu, UzwY, UzwY, Uu, Xos, Xos, UzwY, Uu, Xos, Uu, Xos, Xos, Uu, Uu, Uu, Uu, Uu, UzwY, UzwY, Uu, Uu, Qlf, Uu, Qlf^Bs\, Qlf, Uu, Uu, Uu, Uu, Uu, Uu
Xos, Urc^Edb, Urc^Edb, Urc^Edb, Xos, Uu^Eb, UzwY^FoYg, Xos^FoYg, Uu^FoYg, Uu^FoYg, Qlf^FoYg, Uu^FoYg, Uu^FoYg, Uu^FoYg, Xos, Xos, Xos, UzwY^Eb, Xos, Xos, Xos, UzwY, Xos, Xos, Uu^Viya, Uu, UzwY, UzwY, UzwY, UzwY, Uu, Uu, Xos, UzwY, Uu, Uu, Xos, Xos, Xos, Uu, Uu, Uu, Uu, Uu, UzwY, Uu, Uu, Qlf, Qlf, Qlf, Uu, Uu, Uu, Uu, Uu, Uu, Uh, Uh
Xos, Xos, Xos, Xos, Uu, Xos, UzwY, Xos^FoYg, Uu^FoYg, Qlf^FoYg, Xos^FoYg, Uu^FoYg, Xos, Xos, UzwY^Edb, Xos, UzwY^Edb, UzwY^Edb, Urb^Eb, Urb, Xos, UzwY, UzwY, Xos, UzwY, UzwY, UzwY, UzwY, Uu, Xos, Xos, Xos, Uu, UzwY, Uu^Viya, Xos, Cud, Xos, Xos, Xos, Uu, Uu, UzwY, UzwY, Uu, Uu, Qlf, Qlf, Uu, Uu, Uu, Uu, Uh, Uu, Uu, Uu, Uu, Uh
Xos, Xos, Xos, Xos, Uu, Uu^Viya, UzwY, Xos^FoYg, Qlf^FoYg, Qlf^FoYg, Xos, Xos, UzwY^Edb, UzwY^Edb, Uu^EgkY, UzwY^Edb, UzwY^Edb, UzwY^Edb, UzwY^Edb, Xos, UzwY^Edb, UzwY^Eb, UzwY^Eb, UzwY, UzwY, UzwY, Xos, Uu, Uu, Xos, Uu, Cud, Uu, UzwY, Cud, Cud, Xos, Xos, Xos, Uu, UzwY, Uu, UzwY, Uu, Uu, Qlf, Qlf, Uu, Qlf, Uu, Uu, Uh, Uh, Uh, Uh, Uu, Uu, Uu
Xos, Xos, Xos, Uu, Uu, Xos, Qlf^Bcx|, Qlf, Xos, Xos, UzwY^Edb, UzwY^Edb, QxvY, QxvY, Urb^ZulF, QxvY, QxvY, UzwY^Edb, UzwY^Edb, UzwY^Edb, UzwY^Edb, UzwY^Edb, Xos, UzwY, Xos, Uu, Uu^Viya, Xos, Uu, Xos, Xos, Cud, Cud, UzwY, Cud, UzwY, UzwY, UzwY, UzwY, UzwY, Uu, UzwY, Uu, Uu, Qlf, Qlf, Uu, Uu, Qlf, Qlf, Uu, Uu, Uu, Uu, Uh, Uu, Uu, Uu
Xos, Xos, Xos, Xos, Qlf, Qlf, UzwY, UzwY^Eb, UzwY^Edb, UzwY^Edb, UzwY^Edb, Uu^EgkY, Urb^ZulF, Uu^EgkY, QxvY, Uu^EgkY, Urb^ZulF, Uu^EgkY, 2 UzwY^Edb, UzwY^Edb, UzwY^Edb, UzwY^Edb, UzwY^Edb, Xos, UzwY^Eb, Xos, Xos, Xos, Uu, Uu, Uu, Uu^Viya, UzwY, 4 Kud, UzwY, UzwY, Xos, Xos, Xos, Uu, Uu, Uu, Uu, Uu, Qlf, Uu, Uh, Uh, Uh, Qlf, Uu, Uu, Uu, Uu, Uu, Uh, Uu, Uu
Xos, Xos, Uu, Uu, Qlf, UzwY, Xos, Xos, Urb^Eb, UzwY^Edb, UzwY^Edb, QxvY, Uu^EgkY, QxvY, Urb, QxvY, Uu^EgkY, QxvY, UzwY^Edb, UzwY^Edb, Urb^EgkY, Uu^Eb, Urb^EgkY, UzwY^Edb, UzwY^Eb, Uu^Viya, Uu, Xos, Xos, Xos, UzwY, UzwY, Cud, Cud, Cud, Cud, Xos, Xos, Xos, Uu, Uu, Uu, Uu, Qlf, Uu, Uu, Uh, Uh, Uu, Uu, Uu, Uh, Uh, Uu, Uu, Uu, Uh, Uu
Xos, Xos, Xos, Uu, Qlf, UzwY, Xos, Urb, Xos, UzwY^Edb, UzwY^Edb, QxvY, Urb^ZulF, QxvY, QxvY, QxvY, Urb^ZulF, QxvY, UzwY^Edb, UzwY^Edb, Uu^Eb, QxvY, Uu^Eb, UzwY^Edb, UzwY^Eb, UzwY, UzwY, UzwY, UzwY, UzwY, Uu, UzwY, Xos, Uu, Uu, Uu, Xos, Xos, Xu, Xu, Xu, Uu, Uu, Qlf, Uu, Uu, Uu, Uu, Uu, Uu, Uu, Uu, Qlf, Qlf, Qlf, Uh, Uh, Uh
Xos, Xos, Xos, Uu, Qlf, UzwY, UzwY, Xos, UzwY^Eb, UzwY^Edb, UzwY^Edb, Uu^EgkY, QxvY, Uu^EgkY, Urb^ZulF, Uu^EgkY, QxvY, Uu^EgkY, UzwY^Edb, UzwY^Edb, UzwY^Edb, Urb^EgkY, UzwY^Edb, UzwY^Edb, Xos, Uu, Uu, Xos, Xos, Xos, Uu, UzwY, Uu, Xos, Xos, Xos, Xos, Xos, Xos, Xu, Xu, Xu, Qlf, Qlf, Xu, Xu, Xu, Uu, Xu, Uu, Uh, Uu, Qlf, Qlf, Qlf, Uu, Uu, Uu
Xos, Xos, Xos, Xos, Uu, Qlf, UzwY, UzwY, Xos, UzwY^Edb, UzwY^Edb, UzwY^Edb, UzwY^Edb, QxvY, Uu^EgkY, QxvY, UzwY^Edb, UzwY^Edb, UzwY^Eb, UzwY^Eb, UzwY^Eb, UzwY^Edb, UzwY^Edb, Urb^Eb, Urb, Xos, Uu, Uu, Uu, Uu, Uu, UzwY, UzwY, Xos, Uu, Xos, Uu, Xos, Uu, Xos, Xos, Xu, Qlf, Xu, Xu, Uu, Uu, Uu, Xu, Xu, Xu, Uu, Uh, Uu, Uu, Uu, Uu, Uu
Xos, Xos, Xos, Xos, Xos, Qlf, Qlf^Bcx|, Uu, Uu, Xos, Xos, UzwY^Edb, UzwY^Edb, UzwY^Edb, UzwY^Edb, UzwY^Edb, UzwY^Eb, UzwY^Eb, Urb, Urb, UzwY^Eb, UzwY^Edb, UzwY^Eb, Xos, Xos, Xos, Uu, Xos, Xos, Uu, Xos, Xos, UzwY, Xos, Uu^GYw, Xos, Uu^GYw, Xos, Uu^GYw, Xos, Xos, Xu, Xu, Qlf, Qlf, Xu, Uu, Xu, Xu, Xu, Xu, Uu, Uh, Uh, Uu, Uu, Uu, Uu
Xos, Xos, Xos, Xos, Uu^Viya, Uu, UzwY, Qlf, Qlf, Uu, Xos, Xos, UzwY^Edb, UzwY^Edb, UzwY^Edb, UzwY^Edb, UzwY^Eb, Urb, UzwY^Eb, UzwY^Eb, Xos, Xos, Uu, UzwY, UzwY, Uu^Viya, Uu, Uu, Uu, Xos, Uu, UzwY, UzwY, Xos, Uu, Xos, Uu, Xos, Uu, Xos, Uu, Xos, Xos, Xu, Qlf, Xu, Xu, Xu, Uu, Qlf, Qlf, Uu, Uu, Uh, Uu, Uu, Uu, Uu
Xos, Xos, Uu, Xos, UzwY, UzwY, Xos, Xos, Xos, Qlf, Qlf, Xos, Xos, Xos, Xos, UzwY^Edb, UzwY^Edb, UzwY^Eb, Xos, Xos, Uu, Uu, Xos, UzwY^Eb, Xos, UzwY, UzwY, Xos, Xos, Uu, Uu, Uu, UzwY, Uu^Eb, Uu, Uu, Uu, Uu, Uu, Uu, Uu, Uu, Xos, Xu, Qlf, Xu, Xu, Xu, Xu, Qlf, Qlf, Uu, Uu, Uu, Uu, Uu, Uu, Uu
Xos, Uu, Uu, Uu, UzwY, Xos, Qlf, Xos, Uu^EYt, Uu^EYt, Uu^EYt, Qlf, UzwY, UzwY, UzwY, Xos, UzwY^Eb, Xos, Uu, Uu, Xos, Xos, Xos, Urb, Urb, Xos, Xos, UzwY, UzwY, Xos, Xos, Xos, UzwY, Xos, Uu^GYe, Xos, Uu^GYe, Xos, Uu^GYe, Xos, Xos, Xos, Xu, Xu, Qlf, Xu, Xu, Uu, Uu, Uu, Uu, Uu, Uh, Uu, Uh, Uu, Uu, Uu
Xos, Xos, Uu, UzwY, Xos, Xos, Uu^EYt, Qlf, Qlf, Uu^EYt, Qlf^Bs/, Qlf^Bs/, Xos, Xos, Xos, UzwY, Uu, Uu, Xos, Xos, Urb, Urb, Urb, Xos, Xos, Urb, Urb, Xos, Xos, UzwY, UzwY, Xos, UzwY, Xos, Uu, Xos, Uu, Xos, Uu, Xos, Xu, Xu, Qlf, Qlf, Xu, Xu, Xu, Xu, Uu, Uu, Uh, Uh, Uh, Uh, Uu, Uu, Uu, Uu
Xos, Xos, Uu, UzwY, Xos, Uu^EYt, Uu^EYt, Uu^EYt, Qlf^Bs/, Qlf^Bs/, Uu^EYt, Uu^EYt, Uu^EYt, Xos, Uu^Viya, UzwY, Xos, Xos, Xos, Urb, Urb, Xos, Xos, Urb, Urb, Urb, Xos, Xos, Uu^Viya, Uu, UzwY, UzwY, Xos, Xos, Xos, Xos, Xos, Xos, Xos, Xos, Xu, Qlf, Qlf, Xu, Xu, Xu, Uu, Xu, Uu, Uu, Uu, Uu, Uu, Uu, Uu, Uu, Uu, Uu
Xos, Xos, Xos, UzwY, UzwY, Xos, UzwY, Qlf^Bs/, Uu^EYt, Qlf, Qlf, Uu^EYt, Xos, Xos, UzwY, UzwY, UzwY^Eb, Urb, Urb, Xos, Xos, Urb, Urb, Xos, Xos, Xos, UzwY, UzwY, UzwY, UzwY, Uu, Xos, Xos, Xos, Xos, Xos, Xu, Xu, Xu, Xu, Qlf, Qlf, Qlf, Qlf, Uu, Uu, Xu, Uu, Xu, Xu, Uu, Uu, Uu, Xu, Xu, Uu, Uu, Uu
Xos, Xos, Xos, Uu, Uu, UzwY, Xos, Uu^EYt, Uu^EYt, Uu^EYt, Qlf, Xos, UzwY, UzwY, Xos, UzwY, Xos, Xos, Xos, Urb, Urb, Urb, Xos, Xos, UzwY, UzwY, Xos, Xos, Xos, Xos, Xos, Uu, Xos, Xos, Xu, Xu, Qlf, Qlf, Qlf, Qlf, Xu, Xu, Qlf^Bs/, Qlf^Bs/, Uu, Xu, Xu, Uu, Xu, Xu, Uu, Uu, Xu, Xu, Xu, Uu, Uu, Uu
Xos, Xos, Xos, Xos, Xos, UzwY, Xos, Xos, Xos, Xos, Qlf^Bcx/, UzwY, UzwY, Xos, Qlf, Qlf, Qlf, Qlf, Qlf, Xos, Xos, Xos, Qlf, UzwY, Xos, Uu^Eb, Uu, Uu, Uu, Xos, Xos, Uu, Uu, Xos, Qlf, Qlf, Xu, Xu, Xu, Xu, Uu, Uu, Qlf, Qlf, Xu, Xu, Uu, Uu, Xu, Xu, Xu, Xu, Xu, Xu, Uu, Uu, Uu, Uu
Xos, Xos, Xos, Uu, Uu, UzwY, UzwY, UzwY, UzwY, UzwY, Uu, Qlf, Qlf, Qlf^Bcx\, UzwY, Xos, Xos, Uu^Viya, UzwY, Qlf, Qlf, Qlf, Qlf, Qlf^Bcx|, Qlf, Xos, Xos, Xos, Xos, Xos, Xos, Xos, Xos, Uu, Qlf^Bs\, Xu, Uu, Xu, Xu, Xu, Uu, Xu, Xu, Qlf, Xu, Xu, Xu, Xu, Xu, Xu, Xu, Xu, Xu, Uu, Uu, Xu, Xu, Uu
Xos, Xos, Xos, Uu, Uu, Uu^Viya, Uu, Uu, Uu, Uu, Uu, Uu, Xos, Uu, Uu, UzwY, UzwY, UzwY, Uu, UzwY, UzwY, UzwY, UzwY, UzwY, Uu, Qlf, Qlf, Qlf, Qlf, Qlf, Qlf, Qlf, Qlf, Qlf, Xu, Uu, Xu, Uu, Uu, Uu, Xu, Xu, Xu, Qlf, Qlf, Xu, Xu, Xu, Xu, Xu, Xu, Xu, Xu, Uu, Uu, Xu, Xu, Xu
Xos, Xos, Xos, Xos, Xos, Xos, Xos, Xos, Xos, Uu, Xos, Uu, Uu, Xos, Xos, Xos, Xos, Xos, Xos, Xos, Xos, Uu, Uu, Xos, Xos, Uu, Xos, Xos, Xos, Xos, Xos, Xos, Xos, Xos, Xu, Xu, Xu, Xu, Xu, Xu, Xu, Xu, Xu, Qlf, Qlf, Xu, Xu, Xu, Xu, Xu, Xu, Xu, Xu, Xu, Xu, Xu, Xu, Xu
Xos, Xos, Xos, Xos, Xos, Xos, Xos, Xos, Xos, Xos, Xos, Uu, Xos, Uu, Xos, Xos, Xos, Xos, Xos, Xos, Xos, Xos, Xos, Uu, Xos, Xos, Xos, Xos, Xos, Xos, Xu, Xu, Xu, Xu, Xu, Xu, Xu, Xu, Xu, Xu, Xu, Xu, Xu, Xu, Qlf, Xu, Xu, Xu, Xu, Xu, Xu, Xu, Xu, Xu, Xu, Xu, Xu, Xu
Xos, Xos, Xos, Xos, Xos, Xos, Xos, Xos, Xos, Xos, Xos, Xos, Xos, Xos, Xos, Xos, Xos, Xos, Xos, Xos, Xos, Xos, Xos, Xos, Xos, Xos, Xos, Xos, Xos, Xos, Xu, Xu, Xu, Xu, Xu, Xu, Xu, Xu, Xu, Xu, Xu, Xu, Xu, Xu, Qlf, Qlf, Xu, Xu, Xu, Xu, Xu, Xu, Xu, Xu, Xu, Xu, Xu, Xu
